,oscillator_amplitude,period,sample_last_peak,sample_next_peak,sample_trough,sample_zerox_rise,sample_zerox_decay,time_rise,time_trough,time_ptsym,time_rdsym,time_decay,time_peak,volt_rise,volt_trough,volt_ptsym,volt_rdsym,volt_decay,volt_peak,oscillating
0,27.442521415545293,46,128,174,148,157,139,26,18,0.55,0.5652173913043479,20,22,77.54293797138057,-18.474257227173524,-127.05109107398805,-49.50815310260748,127.05109107398805,108.57683384681452,False
1,34.980215440199665,48,174,222,185,197,178,37,19,0.525,0.7708333333333334,11,21,123.62326792522842,-84.54526577740941,-143.61394652161647,-19.99067859638805,143.61394652161647,59.06868074420704,False
2,19.290057681779803,40,222,262,231,250,226,31,24,0.5471698113207547,0.775,9,29,161.57309491287083,-87.41934768809263,-126.49734983591165,35.07574507695918,126.49734983591165,39.078002147819014,False
3,18.898691509633196,53,262,315,308,311,280,7,31,0.4918032786885246,0.13207547169811318,46,30,113.25229265609929,15.490504523554527,-58.66324270122369,54.5890499548756,58.66324270122369,74.15374722477821,False
4,20.070945151000778,29,315,344,328,334,324,16,10,0.5652173913043479,0.5517241379310345,13,13,140.17539922727843,31.15574774676661,-97.58704943288721,42.58834979439122,97.58704943288721,128.74279717965382,False
5,46.69645075096283,36,344,380,361,371,355,19,16,0.5675675675675675,0.5277777777777778,17,21,158.9442529665688,-25.884825966492162,-197.21597294053723,-38.27171997396843,197.21597294053723,171.33114697404505,False
6,29.938703526995816,54,380,434,415,420,392,19,28,0.4285714285714286,0.35185185185185186,35,21,100.86080698033575,-39.118954800153205,-172.17838180022983,-71.31757481989408,172.17838180022983,133.05942700007662,False
7,39.27131306416576,53,434,487,466,472,443,21,29,0.4423076923076923,0.39622641509433965,32,23,123.15653404128497,-54.10275294697129,-115.84460512715384,7.31192891413113,115.84460512715384,61.741852180182555,False
8,28.176247401012443,26,487,513,500,504,493,13,11,0.65625,0.5,13,21,144.85319435796606,-68.43854967967523,-137.4923307739889,7.360863583977164,137.4923307739889,69.05378109431368,False
9,16.356793558625586,36,513,549,536,541,522,13,19,0.4864864864864865,0.36111111111111116,23,18,75.2069561972908,-17.01600788066385,-93.43065255895469,-18.223696361663897,93.43065255895469,76.41464467829084,False
10,8.74131527789172,31,549,580,565,569,555,15,14,0.5,0.4838709677419355,16,14,58.44439932054316,-38.22280635539275,-96.41375467201969,-37.96935535147653,96.41375467201969,58.190948316626944,False
11,28.3504202131848,36,580,616,600,607,587,16,20,0.4736842105263158,0.4444444444444444,20,18,147.26919987728633,-91.71812201587801,-111.93971498102843,35.329484896257895,111.93971498102843,20.221592965150414,False
12,16.85380370508541,28,616,644,627,634,619,17,15,0.4444444444444444,0.6071428571428572,11,12,71.61401126144122,-94.31115426322006,-149.86223212462838,-78.24822086318716,149.86223212462838,55.551077861408324,False
13,38.67848227871159,45,644,689,665,675,653,24,22,0.46341463414634143,0.5333333333333333,21,19,195.79810062587194,-107.56053198853392,-84.86338898675508,110.93471163911686,84.86338898675508,-22.69714300177884,False
14,36.039300193948314,36,689,725,707,721,701,18,20,0.5652173913043479,0.5,18,26,103.73052758429132,-26.72811701127841,-114.96568564861641,-11.235158064325091,114.96568564861641,88.237568637338,False
15,20.00812686725442,32,725,757,738,751,733,19,18,0.4,0.59375,13,12,135.25705856675722,-35.8963679657957,-112.89877853880861,22.35828002794861,112.89877853880861,77.00241057301291,False
16,27.49514683692589,61,757,818,772,794,763,46,31,0.2790697674418605,0.7540983606557377,15,12,151.20297042299572,-22.45555856002843,-121.81624916098994,29.38672126200578,121.81624916098994,99.36069060096152,False
17,75.26066437744713,48,818,866,839,851,830,27,21,0.631578947368421,0.5625,21,36,135.19160972484576,-144.99663157076623,-273.7440434337335,-138.55243370888775,273.7440434337335,128.74741186296728,False
18,51.83116984148724,45,866,911,877,904,872,34,32,0.39622641509433965,0.7555555555555555,11,21,229.97161438917388,-91.65280329635212,-81.84778145043165,148.12383293874223,81.84778145043165,-9.805021845920464,False
19,28.780535086620628,67,911,978,949,957,937,29,20,0.6226415094339622,0.4328358208955224,38,33,61.18179816990019,-36.43015107394928,-174.74896216677104,-113.56716399687085,174.74896216677104,138.31881109282176,False
20,25.094296994496183,65,978,1043,1014,1027,994,29,33,0.5285714285714286,0.4461538461538461,36,37,101.4361407600066,-111.02316315596762,-135.77481025191852,-34.33866949191193,135.77481025191852,24.751647095950904,False
21,35.88502884009789,47,1043,1090,1058,1066,1050,32,16,0.5897435897435898,0.6808510638297872,15,23,207.03452851218645,-172.25026382132592,-162.6632414253649,44.37128708682155,162.6632414253649,-9.587022395961029,False
22,15.898125166260911,28,1090,1118,1091,1103,1091,27,12,0.6756756756756757,0.9642857142857143,1,25,125.93204228354307,42.713151118119946,7.9288864272594,133.86092871080245,-7.9288864272594,34.784264690860546,False
23,19.440352172092123,45,1118,1163,1151,1160,1135,12,25,0.5614035087719298,0.2666666666666667,33,32,66.78663448131694,-28.984022669796996,-197.62921607146,-130.84258159014308,197.62921607146,168.64519340166302,False
24,37.03709977870343,43,1163,1206,1183,1199,1176,23,23,0.41025641025641024,0.5348837209302326,20,16,183.63394419354685,-63.710459174398174,-101.51307098591812,82.12087320762873,101.51307098591812,37.80261181151994,False
25,26.9905308035432,55,1206,1261,1220,1243,1214,41,29,0.34090909090909094,0.7454545454545455,14,15,163.90798926567783,-2.854942209492153,-122.77842722864082,41.129562037037005,122.77842722864082,119.92348501914867,False
26,30.629010934556465,43,1261,1304,1291,1293,1276,13,17,0.6599999999999999,0.3023255813953488,30,33,46.93801703498681,-15.486329889717345,-176.53937694590303,-129.60135991091622,176.53937694590303,161.05304705618568,False
27,24.81350024583276,61,1304,1365,1352,1362,1336,13,26,0.6231884057971014,0.21311475409836067,48,43,117.41342191165327,-65.6194179551608,-97.07110510043026,20.342316811223014,97.07110510043026,31.451687145269464,False
28,40.87796196119295,46,1365,1411,1395,1400,1377,16,23,0.39473684210526316,0.34782608695652173,30,15,199.93999712649787,-100.89112300768798,-152.68512696418045,47.25487016231742,152.68512696418045,51.794003956492475,False
29,20.08201477592449,65,1411,1476,1425,1441,1418,51,23,0.4390243902439024,0.7846153846153846,14,18,156.84063064712163,-24.517105802124114,-123.56597992093401,33.274650726187616,123.56597992093401,99.0488741188099,False
30,56.59084523408483,39,1476,1515,1493,1502,1484,22,18,0.7049180327868853,0.5641025641025641,17,43,109.65017753121491,-0.36808925705787665,-132.69161410205538,-23.041436570840474,132.69161410205538,132.3235248449975,False
31,41.61737004668915,56,1515,1571,1541,1563,1521,30,42,0.3114754098360656,0.5357142857142857,26,19,145.43185730743403,-132.05945048380423,-241.34153875796125,-95.90968145052722,241.34153875796125,109.28208827415703,False
32,9.28439233929975,24,1571,1595,1583,1591,1575,12,16,0.4285714285714286,0.5,12,12,99.158817996403,-34.90506201462396,-48.27746883825376,50.88134915814924,48.27746883825376,13.372406823629804,False
33,25.255383126834584,49,1595,1644,1632,1640,1607,12,33,0.326530612244898,0.24489795918367352,37,16,82.51418504468785,-103.69328669372975,-167.94704267550878,-85.43285763082093,167.94704267550878,64.25375598177905,False
34,25.91524255052083,50,1644,1694,1665,1679,1652,29,27,0.3076923076923077,0.5800000000000001,21,12,182.76175796124906,-116.2266632335552,-95.0475615845133,87.71419637673576,95.0475615845133,-21.1791016490419,False
35,19.07312844115507,33,1694,1727,1701,1717,1696,26,21,0.4473684210526315,0.7878787878787878,7,17,89.4845937652961,-2.7295550776338495,-69.2646498053277,20.21994395996839,69.2646498053277,66.53509472769386,False
36,15.684209129095409,51,1727,1778,1760,1766,1746,18,20,0.5918367346938775,0.3529411764705882,33,29,91.0165436382346,-6.796117388385834,-93.55115607604809,-2.534612437813493,93.55115607604809,86.75503868766225,False
37,22.886393487541774,57,1778,1835,1813,1828,1789,22,39,0.3709677419354839,0.38596491228070173,35,23,136.0119819529308,-31.940388298542267,-116.16081454839102,19.85116740453978,116.16081454839102,84.22042624984876,False
38,22.970798408858535,67,1835,1902,1858,1892,1847,44,45,0.296875,0.6567164179104478,23,19,90.88844742660416,-8.992418717692539,-113.06401237208108,-22.17556494547692,113.06401237208108,104.07159365438854,False
39,36.824310930881936,30,1902,1932,1918,1921,1909,14,12,0.5862068965517242,0.4666666666666667,16,17,132.09170230964466,-83.99179770710475,-165.88782641601637,-33.79612410637171,165.88782641601637,81.89602870891162,False
40,14.49164635599538,74,1932,2006,1972,1987,1967,34,20,0.696969696969697,0.45945945945945943,40,46,101.72791053081205,-102.66259460767675,-150.76249921021667,-49.03458867940462,150.76249921021667,48.099904602539915,False
41,39.22346486974532,31,2006,2037,2022,2027,2017,15,10,0.75,0.4838709677419355,16,30,203.25623231248812,-75.59530634255846,-74.66062226569376,128.59561004679438,74.66062226569376,-0.9346840768646967,False
42,56.184625879064015,36,2037,2073,2057,2068,2051,16,17,0.5853658536585367,0.4444444444444444,20,24,122.07151574727182,-132.21842849448797,-259.87935446441764,-137.80783871714584,259.87935446441764,127.66092596992966,False
43,41.8423217133792,46,2073,2119,2086,2101,2082,33,19,0.4242424242424242,0.7173913043478262,13,14,205.88056899841445,-114.50531098462355,-104.3583982374074,101.52217076100705,104.3583982374074,-10.146912747216154,False
44,36.7009212994986,32,2119,2151,2129,2134,2123,22,11,0.6666666666666667,0.6875,10,22,129.27117210565575,-35.13703575099324,-126.51229376478415,2.758878340871604,126.51229376478415,91.37525801379091,False
45,63.315497655401806,40,2151,2191,2162,2181,2157,29,24,0.4893617021276596,0.725,11,23,186.62947388807794,-47.789194144209745,-141.92333049887225,44.70614338920569,141.92333049887225,94.13413635466252,False
46,101.279444001681,39,2191,2230,2210,2223,2199,20,24,0.4285714285714286,0.5128205128205128,19,18,236.83561378548924,-79.23696852021757,-218.07724826408577,18.758365521403476,218.07724826408577,138.8402797438682,False
47,92.88221335128779,45,2230,2275,2251,2260,2240,24,20,0.45945945945945943,0.5333333333333333,21,17,247.46622083524477,-165.56887755428284,-323.1675228195545,-75.70130198430974,323.1675228195545,157.59864526527167,False
48,84.14199566244221,39,2275,2314,2283,2299,2278,31,21,0.46153846153846156,0.7948717948717949,8,18,226.37783930782956,-65.39091279317556,-147.28825607413748,79.08958323369208,147.28825607413748,81.89734328096192,False
49,106.14090798929378,50,2314,2364,2330,2340,2323,34,17,0.5853658536585367,0.6799999999999999,16,24,285.48311163940946,-180.37950780266289,-341.36643431731693,-55.88332267790747,341.36643431731693,160.98692651465402,False
50,37.84344875685677,65,2364,2429,2382,2402,2371,47,31,0.5,0.7230769230769231,18,31,127.34365254769193,-44.047382793935306,-149.1509866306819,-21.807334082989968,149.1509866306819,105.10360383674659,False
51,70.37865614385161,40,2429,2469,2444,2463,2435,25,28,0.540983606557377,0.625,15,33,155.01115128924795,-19.34400898247138,-102.640278736228,52.37087255301995,102.640278736228,83.29626975375662,False
52,64.15370489185997,48,2469,2517,2484,2496,2479,33,17,0.48484848484848486,0.6875,15,16,142.3385746385624,-128.36041286461824,-264.02755517139485,-121.68898053283246,264.02755517139485,135.66714230677658,False
53,26.545660706911693,39,2517,2556,2522,2535,2519,34,16,0.5897435897435898,0.8717948717948718,5,23,189.6203158257754,-70.72264069595258,-84.70080246989673,104.91951335587868,84.70080246989673,13.978161773944151,False
54,50.25729708577913,31,2556,2587,2567,2580,2560,20,20,0.5555555555555556,0.6451612903225806,11,25,145.28805466022155,13.156628174292884,-105.74104695552995,39.547007704691595,105.74104695552995,118.89767512982283,False
55,76.03561691742489,46,2587,2633,2619,2624,2599,14,25,0.43181818181818177,0.30434782608695654,32,19,201.03243475029626,-106.82568233485028,-265.2703651693647,-64.23793041906845,265.2703651693647,158.44468283451442,False
56,56.50623814420081,51,2633,2684,2650,2658,2640,34,18,0.47058823529411764,0.6666666666666667,17,16,195.5469959699537,-125.95450372482217,-220.16125614026816,-24.614260170314452,220.16125614026816,94.20675241544599,False
57,22.899747666731823,29,2684,2713,2699,2707,2694,14,13,0.7346938775510203,0.48275862068965514,15,36,114.36800847790346,2.4104329287637762,-67.18205931636776,47.1859491615357,67.18205931636776,69.59249224513154,False
58,36.817551212230185,50,2713,2763,2728,2731,2720,35,11,0.5416666666666667,0.7,15,13,131.31994787132535,-129.9297033654908,-246.70814477215805,-115.3881969008327,246.70814477215805,116.77844140666724,False
59,21.263274367612798,33,2763,2796,2776,2787,2772,20,15,0.7321428571428572,0.6060606060606061,13,41,113.6432994370744,-88.91621443012161,-90.30645893595616,23.336840501118246,90.30645893595616,1.3902445058345383,False
60,49.26803255543951,29,2796,2825,2811,2819,2802,14,17,0.46875,0.48275862068965514,15,15,243.1678727030163,-147.29639666308688,-172.02348167003967,71.14439103297661,172.02348167003967,24.727085006952787,False
61,50.44042168821927,42,2825,2867,2851,2856,2831,16,25,0.32432432432432434,0.38095238095238093,26,12,116.87813616266706,-13.917543280839427,-109.78901932076883,7.089116841898232,109.78901932076883,95.8714760399294,False
62,68.11279076592155,45,2867,2912,2894,2903,2876,18,27,0.42553191489361697,0.4,27,20,197.6514392770618,-82.05625524894967,-185.0168481307773,12.634591146284492,185.0168481307773,102.96059288182764,False
63,70.88228011106264,28,2912,2940,2922,2931,2917,18,14,0.5,0.6428571428571428,10,14,298.5140821986817,-109.00357800873842,-224.59876203685053,73.91532016183118,224.59876203685053,115.59518402811212,False
64,112.34257392547295,48,2940,2988,2964,2974,2954,24,20,0.5348837209302326,0.5,24,23,249.38547018563364,-75.17078347547093,-264.6812876654142,-15.295817479780538,264.6812876654142,189.51050418994328,False
65,51.79333594425734,80,2988,3068,3037,3053,3002,31,51,0.35443037974683544,0.38749999999999996,49,28,154.39796190994403,-68.23810302642381,-242.4527897365865,-88.05482782664248,242.4527897365865,174.2146867101627,False
66,156.7650484592447,47,3068,3115,3083,3100,3074,32,26,0.44680851063829785,0.6808510638297872,15,21,418.23938633378816,-209.40556089646438,-295.5654197799846,122.67396655380355,295.5654197799846,86.15985888352022,True
67,184.54072275691337,44,3115,3159,3126,3139,3121,33,18,0.5384615384615384,0.75,11,21,429.8993644114893,-262.568738155185,-471.4025635925088,-41.50319918101951,471.4025635925088,208.8338254373238,True
68,167.56549499707305,51,3159,3210,3170,3188,3167,40,21,0.5714285714285714,0.7843137254901961,11,28,518.5041626657847,-263.75045102620425,-431.08107728250855,87.4230853832762,431.08107728250855,167.3306262563043,True
69,182.09381601574117,50,3210,3260,3220,3242,3216,40,26,0.5185185185185186,0.8,10,28,381.40923373188537,-155.82903084429415,-410.58274248387465,-29.17350875198929,410.58274248387465,254.75371163958047,True
70,211.51756007075926,59,3260,3319,3275,3290,3271,44,19,0.6041666666666667,0.7457627118644068,15,29,670.494511552625,-353.33282619560094,-578.9130290831921,91.5814824694329,578.9130290831921,225.58020288759118,True
71,232.88876658108038,54,3319,3373,3332,3350,3326,41,24,0.6,0.7592592592592593,13,36,443.075951797545,-276.2931281148784,-593.4548134719024,-150.37886167435744,593.4548134719024,317.161685357024,True
72,227.7309366319894,62,3373,3435,3393,3405,3385,42,20,0.6363636363636364,0.6774193548387097,20,35,751.0259501126345,-510.3644664947929,-677.1472901774595,73.87865993517505,677.1472901774595,166.78282368266656,True
73,220.87921446243058,55,3435,3490,3459,3467,3450,31,17,0.7258064516129032,0.5636363636363637,24,45,478.5987740874351,-239.506252467395,-480.1677360852366,-1.5689619978014662,480.1677360852366,240.6614836178416,True
74,238.48562042173867,48,3490,3538,3505,3520,3499,33,21,0.6037735849056604,0.6875,15,32,627.5804888686362,-342.5065446230985,-581.5990662431386,45.981422625497544,581.5990662431386,239.09252162004015,True
75,234.78433521559427,78,3538,3616,3569,3578,3563,47,15,0.7413793103448276,0.6025641025641026,31,43,940.9137872771515,-666.9379201782485,-952.0118644237862,-11.098077146634637,952.0118644237862,285.07394424553763,True
76,186.18249533955236,49,3616,3665,3635,3648,3626,30,22,0.6857142857142857,0.6122448979591837,19,48,386.38961253132413,-252.14635356919624,-526.1222206680992,-139.73260813677507,526.1222206680992,273.975867098903,True
77,72.14976141928037,37,3665,3702,3694,3697,3678,8,19,0.6122448979591837,0.21621621621621623,29,30,78.75267113287981,-68.04010088347874,-202.28335984560667,-123.53068871272686,202.28335984560667,134.24325896212792,False
78,70.33518321277154,41,3702,3743,3724,3735,3715,19,20,0.4736842105263158,0.46341463414634143,22,18,245.64132616209088,-168.73333240778638,-179.44590265718745,66.19542350490343,179.44590265718745,10.712570249401061,False
79,104.49049706584799,62,3743,3805,3764,3792,3759,41,33,0.42105263157894735,0.6612903225806452,21,24,270.2968790072793,-119.33879692417536,-196.24679067847984,74.05008832879946,196.24679067847984,76.9079937543045,False
80,184.30207010907074,39,3805,3844,3820,3833,3810,24,23,0.4390243902439024,0.6153846153846154,15,18,376.0246205169801,-173.09245990013443,-324.0505419832384,51.974078533741704,324.0505419832384,150.95808208310396,True
81,247.6282598313451,62,3844,3906,3871,3888,3862,35,26,0.5272727272727273,0.564516129032258,27,29,731.9682936984989,-365.6291384943711,-568.5612991112168,163.40699458728204,568.5612991112168,202.9321606168457,True
82,106.83183916453577,61,3906,3967,3925,3944,3915,42,29,0.4821428571428571,0.6885245901639344,19,27,169.25468071687874,-25.231446734071554,-391.57060193819933,-222.3159212213206,391.57060193819933,366.3391552041278,False
83,60.62900539125048,51,3967,4018,4003,4013,3981,15,32,0.536231884057971,0.2941176470588235,36,37,253.30528469374747,-119.50736820504495,-263.53060218785214,-10.225317494104672,263.53060218785214,144.0232339828072,False
84,71.69258153602257,50,4018,4068,4036,4056,4025,32,31,0.2790697674418605,0.64,18,12,242.85132354255063,-130.4431868164549,-264.24110330515737,-21.389779762606736,264.24110330515737,133.7979164887025,False
85,146.1449205502748,42,4068,4110,4078,4093,4073,32,20,0.45945945945945943,0.7619047619047619,10,17,374.2511029271504,-103.96135183917482,-216.36948856527056,157.88161436187983,216.36948856527056,112.40813672609573,False
86,241.48434755515916,49,4110,4159,4124,4137,4119,35,18,0.5909090909090908,0.7142857142857143,14,26,575.237127788783,-376.5862435055243,-646.8759945934999,-71.63886680471683,646.8759945934999,270.28975108797556,True
87,193.501103305007,36,4159,4195,4170,4183,4163,25,20,0.5652173913043479,0.6944444444444444,11,26,455.6482530260967,-238.18976047219905,-436.8406447554578,18.807608270638923,436.8406447554578,198.65088428325873,True
88,173.40842736955122,54,4195,4249,4214,4219,4208,35,11,0.6944444444444444,0.6481481481481481,19,25,498.5976428013943,-271.2260840426117,-488.6845765965094,9.913066204884899,488.6845765965094,217.45849255389766,True
89,228.92050429427525,36,4249,4285,4263,4275,4258,22,17,0.6964285714285714,0.6111111111111112,14,39,498.1909808516343,-252.03135260442443,-479.40291136320695,18.788069488427368,479.40291136320695,227.37155875878253,True
90,403.22627466759644,67,4285,4352,4320,4329,4313,32,16,0.7037037037037037,0.4776119402985075,35,38,1263.2600487387922,-864.2822970418104,-1110.4419252890202,152.81812344977197,1110.4419252890202,246.15962824720992,True
91,497.0901380844391,53,4352,4405,4378,4387,4372,27,15,0.7413793103448276,0.5094339622641509,26,43,1366.9249128643376,-971.7903523848423,-1370.768104081824,-3.843191217486492,1370.768104081824,398.9777516969817,True
92,407.0580767083023,57,4405,4462,4436,4444,4429,26,15,0.736842105263158,0.45614035087719296,31,42,954.7619296822782,-616.4043179259901,-1011.5388784054853,-56.77694872320717,1011.5388784054853,395.1345604794952,True
93,255.01018313912735,78,4462,4540,4487,4497,4478,53,19,0.6415094339622642,0.6794871794871795,25,34,706.4718580584395,-497.6725154294183,-836.0301271857063,-129.55826912726684,836.0301271857063,338.35761175628807,True
94,307.35494192786945,48,4540,4588,4553,4567,4546,35,21,0.7,0.7291666666666667,13,49,973.2194255387014,-538.3703922308131,-747.1697348598343,226.04969067886714,747.1697348598343,208.7993426290212,True
95,256.70203561601335,83,4588,4671,4623,4635,4616,48,19,0.7205882352941176,0.5783132530120482,35,49,1126.8815783101293,-829.0260482509668,-1263.875081558855,-136.9935032487258,1263.875081558855,434.8490333078883,True
96,177.34392633143858,51,4671,4722,4690,4702,4678,32,24,0.6417910447761195,0.6274509803921569,19,43,363.67972269534073,-163.67777871769405,-461.53330877685653,-97.8535860815158,461.53330877685653,297.8555300591625,True
97,137.73493031232354,45,4722,4767,4751,4757,4734,16,23,0.5818181818181818,0.3555555555555555,29,32,249.6643783971465,-37.87300465083632,-237.87494862848297,11.789429768663524,237.87494862848297,200.00194397764665,False
98,163.70933366543431,76,4767,4843,4791,4800,4784,52,16,0.627906976744186,0.6842105263157895,24,27,708.6084817849031,-456.74678669716883,-668.538160443479,40.07032134142412,668.538160443479,211.79137374631017,True
99,232.93393876867026,50,4843,4893,4857,4865,4852,36,13,0.8,0.72,14,52,727.5719561165478,-569.2464894936808,-821.108184581415,-93.53622846486724,821.108184581415,251.86169508773426,True
100,129.0268944959105,43,4893,4936,4914,4920,4906,22,14,0.7454545454545455,0.5116279069767442,21,41,346.78074795710285,-270.8235087634532,-429.1489753863202,-82.36822742921737,429.1489753863202,158.325466622867,False
101,34.2729587537538,23,4936,4959,4953,4956,4936,6,20,0.4444444444444444,0.26086956521739135,17,16,64.83329437123655,55.606114669233044,-20.351124524416583,44.482169846819964,20.351124524416583,75.95723919364963,False
102,35.928755519013855,46,4959,5005,4985,4996,4978,20,18,0.55,0.4347826086956522,26,22,120.33414342128417,-23.858696333671915,-144.29810537414153,-23.96396195285736,144.29810537414153,120.4394090404696,False
103,56.16138053519384,57,5005,5062,5032,5049,5012,30,37,0.30188679245283023,0.5263157894736843,27,16,179.81880669684693,-78.99181225721169,-175.46725934482396,4.351547352022976,175.46725934482396,96.47544708761225,False
104,54.58022326277184,59,5062,5121,5073,5106,5065,48,41,0.2807017543859649,0.8135593220338984,11,16,231.63933898386256,-45.95531830816368,-146.78231274779893,84.85702623606363,146.78231274779893,100.82699443963523,False
105,35.86466974914234,59,5121,5180,5161,5174,5126,19,48,0.2941176470588235,0.3220338983050848,40,20,123.68893340516513,-41.211103041868704,-226.89512371756757,-103.20619031240244,226.89512371756757,185.68402067569886,False
106,32.305029524682546,43,5180,5223,5190,5203,5186,33,17,0.4137931034482759,0.7674418604651163,10,12,108.22635368116909,-31.898566708837656,-114.3763970721341,-6.15004339096501,114.3763970721341,82.47783036329643,False
107,30.28061986017516,41,5223,5264,5232,5249,5228,32,21,0.5434782608695652,0.7804878048780488,9,25,100.75652381852092,-28.70224165706833,-105.03002862939977,-4.273504810878848,105.03002862939977,76.32778697233144,False
108,28.930535833057558,28,5264,5292,5274,5287,5268,18,19,0.5,0.6428571428571428,10,19,103.12876195370715,-31.40792026056346,-103.46220242201605,-0.3334404683088934,103.46220242201605,72.05428216145259,False
109,44.040123455392255,46,5292,5338,5323,5328,5305,15,23,0.4390243902439024,0.32608695652173914,31,18,114.71562734361066,-74.55397586505997,-146.27481755820367,-31.559190214593002,146.27481755820367,71.7208416931437,False
110,28.58124579499582,38,5338,5376,5352,5370,5343,24,27,0.3571428571428571,0.631578947368421,14,15,101.10010879802553,-85.4495920726881,-125.6112435512388,-24.51113475321327,125.6112435512388,40.161651478550695,False
111,35.11898167586887,37,5376,5413,5384,5395,5380,29,15,0.4,0.7837837837837838,8,10,234.94555828703795,-159.74605100427306,-175.3965677296105,59.54899055742746,175.3965677296105,15.650516725337429,False
112,10.430185211849244,30,5413,5443,5425,5435,5419,18,16,0.6,0.6,12,24,66.98921399743557,40.39184523128842,-34.80766205147648,32.18155194595909,34.80766205147648,75.1995072827649,False
113,24.033916823674524,51,5443,5494,5465,5475,5456,29,19,0.525,0.5686274509803921,22,21,43.15456646517529,15.542730224597907,-91.8383290041261,-48.6837625389508,91.8383290041261,107.381059228724,False
114,16.752337635695774,53,5494,5547,5510,5523,5503,37,20,0.5833333333333333,0.6981132075471699,16,28,44.735980420458745,-35.809721076765754,-94.50701776653895,-49.771037346080206,94.50701776653895,58.6972966897732,False
115,29.559133957887614,56,5547,5603,5580,5591,5560,23,31,0.5441176470588236,0.4107142857142857,33,37,135.65312329587155,-73.41093577937357,-82.33719512306656,53.31592817280499,82.33719512306656,8.92625934369299,False
116,75.766547606884,37,5603,5640,5622,5631,5609,18,22,0.44999999999999996,0.4864864864864865,19,18,266.1246429300122,-102.54818224515797,-164.79036976165594,101.33427316835628,164.79036976165594,62.24218751649797,False
117,56.94266199550145,48,5640,5688,5655,5667,5646,33,21,0.41666666666666663,0.6875,15,15,104.72261829622997,-27.601012581559758,-191.17747326641398,-86.45485497018402,191.17747326641398,163.57646068485423,False
118,93.293797174278,48,5688,5736,5712,5722,5702,24,20,0.6363636363636364,0.5,24,35,266.9899718753242,-144.35941871866174,-221.48102443333195,45.50894744199226,221.48102443333195,77.12160571467021,False
119,96.6876244661789,40,5736,5776,5754,5763,5742,22,21,0.4878048780487805,0.55,18,20,230.3009964736437,-87.08359850609871,-209.7141516627612,20.586844810882496,209.7141516627612,122.63055315666249,False
120,48.864587012018546,35,5776,5811,5788,5797,5781,23,16,0.5294117647058824,0.6571428571428571,12,18,122.1487483762275,-28.092245388777187,-171.30964335632217,-49.16089498009467,171.30964335632217,143.217397967545,False
121,52.248239244083486,34,5811,5845,5816,5830,5813,29,17,0.48484848484848486,0.8529411764705882,5,16,117.26687362696731,20.60446435012369,-73.45203863732662,43.81483498964069,73.45203863732662,94.05650298745032,False
122,154.7372555159467,51,5845,5896,5864,5882,5856,32,26,0.5,0.6274509803921569,19,26,397.9084054793228,-191.10543459805993,-328.9767725751509,68.93163290417192,328.9767725751509,137.871337977091,False
123,202.66706901681042,53,5896,5949,5925,5937,5909,24,28,0.49090909090909096,0.4528301886792453,29,27,459.23595269024304,-246.35042613637106,-453.1533970176339,6.082555672609146,453.1533970176339,206.80297088126287,True
124,147.1870539929135,62,5949,6011,5970,5994,5959,41,35,0.38596491228070173,0.6612903225806452,21,22,407.2222380573088,-195.08169575548737,-407.9672223093594,-0.7449842520505854,407.9672223093594,212.885526553872,False
125,77.48379054650826,51,6011,6062,6046,6051,6020,16,31,0.45614035087719296,0.3137254901960784,35,26,125.55280113049753,-49.74765981404263,-261.88820211586403,-136.3354009853665,261.88820211586403,212.1405423018214,False
126,51.30639060354942,51,6062,6113,6096,6105,6078,17,27,0.5,0.33333333333333337,34,27,268.2809275099481,-59.04014763204445,-134.84528894849933,133.4356385614488,134.84528894849933,75.8051413164549,False
127,43.49697391032071,71,6113,6184,6154,6169,6130,30,39,0.390625,0.4225352112676056,41,25,166.79240835658322,-69.69273370245162,-278.93351358035534,-112.14110522377212,278.93351358035534,209.2407798779037,False
128,24.629448054844275,51,6184,6235,6226,6230,6190,9,40,0.34426229508196726,0.17647058823529416,42,21,105.23112715424818,-52.373356215188785,-149.4730308693204,-44.241903715072226,149.4730308693204,97.09967465413162,False
129,26.409127251697864,50,6235,6285,6272,6277,6254,13,23,0.5106382978723405,0.26,37,24,74.5208341045448,-74.48647353545016,-127.34424447450957,-52.82341036996476,127.34424447450957,52.8577709390594,False
130,64.3593622794872,37,6285,6322,6296,6313,6290,26,23,0.36111111111111116,0.7027027027027026,11,13,203.49708112702024,-136.7085824515631,-136.74294302065775,66.75413810636249,136.74294302065775,0.03436056909464602,False
131,116.08013375848316,43,6322,6365,6340,6352,6332,25,20,0.4871794871794872,0.5813953488372092,18,19,296.28680809319815,-169.48191754602314,-236.27041622148027,60.01639187171787,236.27041622148027,66.78849867545715,False
132,171.32485467974672,50,6365,6415,6385,6398,6374,30,24,0.4782608695652174,0.6,20,22,385.17895082456835,-143.70833076386143,-270.51322131103643,114.66572951353191,270.51322131103643,126.804890547175,True
133,232.9412580396341,48,6415,6463,6430,6439,6420,33,19,0.5365853658536586,0.6875,15,22,566.9102269113914,-269.51215416144794,-510.98277422215483,55.92745268923659,510.98277422215483,241.47062006070692,True
134,265.90986396124555,51,6463,6514,6485,6492,6477,29,15,0.7169811320754718,0.5686274509803921,22,38,609.2250212135432,-443.2301767741973,-740.6282495241408,-131.40322831059757,740.6282495241408,297.3980727499435,True
135,150.95341657262057,52,6514,6566,6532,6541,6526,34,15,0.6938775510204082,0.6538461538461539,18,34,416.7992426335694,-275.6817538816684,-441.67659832101435,-24.877355687444947,441.67659832101435,165.99484443934597,False
136,193.61133346913792,56,6566,6622,6590,6605,6586,32,19,0.703125,0.5714285714285714,24,45,549.5110317830082,-380.7091337846346,-521.8266225365356,27.68440924647257,521.8266225365356,141.11748875190102,True
137,143.7605427656655,65,6622,6687,6640,6655,6635,47,20,0.6,0.7230769230769231,18,30,353.53136714736274,-184.76701995761158,-353.56891795598517,-0.03755080862242721,353.56891795598517,168.80189799837356,False
138,213.09794532085084,50,6687,6737,6701,6713,6694,36,19,0.6724137931034483,0.72,14,39,618.3422275726357,-378.8235803584671,-547.5879275482182,70.75430002441749,547.5879275482182,168.76434718975116,True
139,164.89295086578218,38,6737,6775,6755,6763,6747,20,16,0.6799999999999999,0.5263157894736843,18,34,319.89460158986105,-156.83153166141176,-396.35017887558035,-76.4555772857193,396.35017887558035,239.51864721416857,True
140,199.7027690267627,64,6775,6839,6799,6808,6792,40,16,0.6444444444444444,0.625,24,29,434.038874659329,-178.79555798432273,-341.858627912772,92.18024674655697,341.858627912772,163.06306992844932,True
141,319.6665633953556,65,6839,6904,6854,6866,6850,50,16,0.7241379310344828,0.7692307692307692,15,42,1469.9624874328147,-991.7745384276997,-1247.0178551027059,222.9446323301088,1247.0178551027059,255.24331667500627,True
142,372.92918906186225,58,6904,6962,6930,6940,6923,32,17,0.7702702702702703,0.5517241379310345,26,57,1140.4438954935981,-766.2043282952776,-1244.3922773003926,-103.94838180679449,1244.3922773003926,478.18794900511494,True
143,183.45974744064264,53,6962,7015,6986,7000,6977,29,23,0.6166666666666667,0.5471698113207547,24,37,248.68399241694777,-212.61855570363085,-586.8581229019514,-338.1741304850037,586.8581229019514,374.23956719832063,True
144,171.18862897924214,58,7015,7073,7027,7036,7020,46,16,0.5555555555555556,0.7931034482758621,12,20,604.9815185784738,-327.14058162594273,-363.2060183392597,241.77550023921413,363.2060183392597,36.06543671331694,True
145,395.87383167372826,48,7073,7121,7087,7097,7082,34,15,0.7540983606557377,0.7083333333333333,14,46,1162.5323808603146,-869.4454602186166,-1147.2863971711477,15.245983689166906,1147.2863971711477,277.8409369525311,True
146,219.75419589620728,38,7121,7159,7144,7149,7129,15,20,0.6153846153846154,0.39473684210526316,23,32,312.1091104821898,-201.35151971971584,-494.4384403614138,-182.32932987922402,494.4384403614138,293.086920641698,True
147,134.49335717998642,47,7159,7206,7174,7181,7170,32,11,0.65625,0.6808510638297872,15,21,486.1031236362455,-346.2525653052422,-457.01015606771614,29.09296756852939,457.01015606771614,110.75759076247398,False
148,103.62432706824305,28,7206,7234,7217,7221,7212,17,9,0.775,0.6071428571428572,11,31,372.6593932605109,-155.38074875415458,-295.23130708515794,77.42808617535297,295.23130708515794,139.85055833100336,False
149,98.60221722028865,51,7234,7285,7269,7280,7247,16,33,0.44067796610169496,0.3137254901960784,35,26,311.2403427388643,-50.36579893981842,-267.64444344617476,43.59589929268952,267.64444344617476,217.27864450635633,False
150,126.47468285295437,46,7285,7331,7300,7318,7293,31,25,0.3421052631578947,0.6739130434782609,15,13,262.45708257596107,-69.84727595546006,-330.72181975450593,-68.26473717854486,330.72181975450593,260.87454379904585,False
151,159.36063410823078,63,7331,7394,7350,7362,7339,44,23,0.4772727272727273,0.6984126984126984,19,21,330.4546553564949,-126.46820615146446,-319.07801277196546,11.376642584529463,319.07801277196546,192.609806620501,True
152,285.1524647773706,57,7394,7451,7407,7419,7401,44,18,0.6842105263157895,0.7719298245614035,13,39,912.8626087226828,-626.9391704616053,-830.9256196666357,81.93698905604708,830.9256196666357,203.98644920503048,True
153,290.38707391393666,70,7451,7521,7475,7485,7467,46,18,0.7272727272727273,0.6571428571428571,24,48,943.5923151951764,-706.2139201512431,-992.1373584123207,-48.545043217144325,992.1373584123207,285.9234382610776,True
154,381.21537861222123,39,7521,7560,7536,7546,7530,24,16,0.7377049180327868,0.6153846153846154,15,45,890.7239928486688,-576.1920868275301,-813.5704818714635,77.15351097720531,813.5704818714635,237.37839504393332,True
155,411.75289666240855,55,7560,7615,7590,7601,7580,25,21,0.6181818181818182,0.4545454545454546,30,34,971.5922207820554,-540.0126696435057,-854.5445756646443,117.0476451174111,854.5445756646443,314.53190602113864,True
156,388.5656984719753,63,7615,7678,7648,7659,7641,30,18,0.6896551724137931,0.47619047619047616,33,40,1116.8638916326454,-751.7710991825384,-1183.350650321088,-66.4867586884427,1183.350650321088,431.5795511385497,True
157,201.5222733705286,50,7678,7728,7702,7709,7689,26,20,0.6,0.52,24,30,245.5980566160323,-114.08225771501971,-479.17505016512666,-233.57699354909437,479.17505016512666,365.09279245010697,True
158,55.694976949807675,56,7728,7784,7746,7760,7737,38,23,0.5490196078431373,0.6785714285714286,18,28,179.83201907127454,-29.634814818125403,-161.15061371913797,18.68140535213658,161.15061371913797,131.51579890101257,False
159,25.61206690740656,31,7784,7815,7809,7813,7798,6,15,0.7169811320754718,0.19354838709677424,25,38,46.07944362216986,11.508842412979586,-138.68836184016956,-92.6089182179997,138.68836184016956,150.19720425314915,False
160,17.688608810293484,34,7815,7849,7840,7845,7827,9,18,0.4375,0.2647058823529411,25,14,122.92071283751628,-80.25724349021455,-137.845529525364,-14.92481668784771,137.845529525364,57.58828603514945,False
161,34.03843102296039,40,7849,7889,7867,7879,7860,22,19,0.4411764705882353,0.55,18,15,132.12682008983302,-104.59319979362445,-147.25666914092616,-15.129849051093146,147.25666914092616,42.66346934730172,False
162,179.19518082554677,53,7889,7942,7904,7920,7892,38,28,0.31707317073170727,0.7169811320754718,15,13,518.2582667852782,-150.3065424380094,-177.84016273421793,340.4181040510603,177.84016273421793,27.533620296208554,True
163,363.1271889064537,50,7942,7992,7966,7974,7957,26,17,0.6851851851851851,0.52,24,37,883.1282667025538,-759.618873568005,-1127.5705979152738,-244.44233121271998,1127.5705979152738,367.9517243472688,True
164,112.71304405974966,35,7992,8027,8005,8008,8001,22,7,0.7941176470588236,0.6285714285714286,13,27,94.45565588391302,31.902279341542876,-91.60711379300587,2.8485420909071593,91.60711379300587,123.50939313454874,False
165,35.76730075191656,41,8027,8068,8055,8063,8046,13,17,0.6909090909090909,0.31707317073170727,28,38,165.7266548387725,-137.80813100099635,-264.16606622645224,-98.43941138767974,264.16606622645224,126.3579352254559,False
166,37.68094512344299,34,8068,8102,8079,8092,8073,23,19,0.3448275862068966,0.6764705882352942,11,10,248.45608148672835,-67.32892299084968,-95.24744682862584,153.2086346581025,95.24744682862584,27.91852383777616,False
167,46.843164354149835,70,8102,8172,8149,8164,8122,23,42,0.41666666666666663,0.3285714285714286,47,30,157.01902161069893,-97.79396760770246,-278.9211261035812,-121.90210449288224,278.9211261035812,181.1271584958787,False
168,96.39734586596967,45,8172,8217,8196,8205,8185,21,20,0.5121951219512195,0.4666666666666667,24,21,304.5238823250547,-66.95076515412116,-126.17581915711763,178.34806316793703,126.17581915711763,59.22505400299647,False
169,55.14667620618102,67,8217,8284,8263,8273,8228,21,45,0.3382352941176471,0.31343283582089554,46,23,218.51226194367567,-173.8445221080136,-411.41763927894715,-192.90537733527148,411.41763927894715,237.57311717093353,False
170,89.67743349044312,55,8284,8339,8315,8327,8299,24,28,0.4814814814814815,0.4363636363636364,31,26,333.5953390584547,-235.0703940629925,-279.7381338986546,53.85720515980012,279.7381338986546,44.66773983566208,False
171,63.830525939615384,44,8339,8383,8355,8365,8348,28,17,0.5526315789473684,0.6363636363636364,16,21,168.68790651010147,-18.784676935381043,-117.30962193084325,51.37828457925822,117.30962193084325,98.5249449954622,False
172,118.0568661548096,44,8383,8427,8403,8409,8388,24,21,0.5227272727272727,0.5454545454545454,20,23,211.5442109491142,-52.34251182936974,-202.24574140409015,9.298469545024034,202.24574140409015,149.90322957472043,False
173,214.48157030821926,55,8427,8482,8445,8458,8438,37,20,0.5918367346938775,0.6727272727272727,18,29,599.2150696921744,-283.488722217835,-442.69042133757944,156.524648354595,442.69042133757944,159.20169911974446,True
174,388.91001989772707,60,8482,8542,8509,8519,8500,33,19,0.6885245901639344,0.55,27,42,1123.7766555688786,-778.9593414743646,-1094.685688948704,29.09096662017464,1094.685688948704,315.7263474743394,True
175,226.57154087723103,54,8542,8596,8569,8574,8551,27,23,0.5818181818181818,0.5,27,32,285.6923828959138,-90.97639395421722,-435.79370804873133,-150.10132515281754,435.79370804873133,344.81731409451413,True
176,307.73165770276535,50,8596,8646,8613,8624,8607,33,17,0.6599999999999999,0.6599999999999999,17,33,862.3087175178257,-591.0696255662314,-785.7856145079279,76.5231030098978,785.7856145079279,194.71598894169657,True
177,310.1976162390299,54,8646,8700,8669,8678,8661,31,17,0.6851851851851851,0.5740740740740741,23,37,802.9970155068031,-472.6809502382819,-743.9200421898763,59.0769733169268,743.9200421898763,271.2390919515944,True
178,347.03504347607793,50,8700,8750,8726,8736,8717,24,19,0.6724137931034483,0.48,26,39,745.4305837851875,-436.25786512774823,-766.5739303962694,-21.143346611081824,766.5739303962694,330.31606526852113,True
179,391.2261380879879,61,8750,8811,8777,8788,8770,34,18,0.6538461538461539,0.5573770491803278,27,34,966.4266036842166,-519.6373558243146,-828.8100744817539,137.61652920246274,828.8100744817539,309.17271865743936,True
180,430.93927256133327,46,8811,8857,8828,8837,8820,29,17,0.653061224489796,0.6304347826086957,17,32,860.4304462537682,-511.80345367818893,-958.592701538091,-98.16225528432278,958.592701538091,446.78924785990205,True
181,399.6675147403767,53,8857,8910,8878,8888,8871,32,17,0.6666666666666667,0.6037735849056604,21,34,971.181850665616,-675.4195739116799,-1024.0465664872593,-52.864715821643244,1024.0465664872593,348.6269925755793,True
182,301.12047960085005,55,8910,8965,8936,8948,8929,29,19,0.6833333333333333,0.5272727272727273,26,41,790.3737186674318,-510.97853405509994,-806.740810809036,-16.36709214160419,806.740810809036,295.76227675393613,True
183,298.19798333855766,71,8965,9036,9003,9014,8995,33,19,0.7121212121212122,0.46478873239436624,38,47,1007.4353796423709,-669.3587881298283,-948.7539727421603,58.68140690021062,948.7539727421603,279.39518461233195,True
184,224.0577745478114,51,9036,9087,9069,9077,9060,18,17,0.7301587301587302,0.3529411764705882,33,46,578.1959285036296,-437.8317667483963,-775.9083582609389,-197.71242975730934,775.9083582609389,338.07659151254256,True
185,75.5426599860098,65,9087,9152,9134,9146,9109,18,37,0.46376811594202894,0.27692307692307694,47,32,177.0638219747188,-100.14765389677326,-240.51181565200653,-63.44799367728774,240.51181565200653,140.36416175523325,False
186,81.6494017872966,69,9152,9221,9184,9202,9171,37,31,0.4464285714285714,0.536231884057971,32,25,285.6196900826935,-103.92385025455835,-180.84001833250386,104.77967175018966,180.84001833250386,76.91616807794553,False
187,68.45580522858205,34,9221,9255,9240,9248,9232,15,16,0.6521739130434783,0.4411764705882353,19,30,143.75466596374824,-81.20058716788535,-262.8964269960205,-119.14176103227229,262.8964269960205,181.6958398281352,False
188,92.87218575687405,65,9255,9320,9284,9296,9264,36,32,0.33333333333333337,0.5538461538461539,29,16,296.9121830943313,-123.11016230739655,-185.66424110325946,111.24794199107183,185.66424110325946,62.5540787958629,False
189,264.12551623118435,56,9320,9376,9345,9356,9334,31,22,0.6333333333333333,0.5535714285714286,25,38,720.8935984086147,-470.5020654835392,-644.3040862704739,76.58951213814078,644.3040862704739,173.80202078693472,True
190,215.32508954441576,48,9376,9424,9395,9404,9385,29,19,0.6041666666666667,0.6041666666666667,19,29,407.2306393937011,-162.5534584651738,-412.94499139024936,-5.71435199654826,412.94499139024936,250.39153292507555,True
191,183.60290700561177,63,9424,9487,9449,9462,9440,38,22,0.6206896551724138,0.6031746031746033,25,36,513.1484913088465,-294.67607233208975,-539.3532532606171,-26.204761951770593,539.3532532606171,244.6771809285273,True
192,88.7983219387029,35,9487,9522,9509,9515,9495,13,20,0.6226415094339622,0.37142857142857144,22,33,95.04474179025438,-48.67012741185001,-267.1425463886067,-172.09780459835235,267.1425463886067,218.47241897675673,False
193,73.51769476944821,70,9522,9592,9561,9570,9551,31,19,0.6545454545454545,0.44285714285714284,39,36,275.7961817640121,-171.04176015116136,-217.41637452956573,58.37980723444636,217.41637452956573,46.37461437840437,False
194,102.6709122037605,58,9592,9650,9629,9641,9602,21,39,0.45070422535211263,0.3620689655172413,37,32,328.08794214996414,-111.63854060878589,-216.39296222163665,111.69497992832748,216.39296222163665,104.75442161285076,False
195,135.18037819524633,66,9650,9716,9675,9687,9666,41,21,0.5434782608695652,0.6212121212121212,25,25,386.7289855338714,-208.94631196722852,-425.39571350840674,-38.66672797453532,425.39571350840674,216.44940154117825,False
196,111.2729571666148,59,9716,9775,9748,9761,9732,27,29,0.6081081081081081,0.4576271186440678,32,45,215.4824082404097,-55.28708159524986,-233.06975516189277,-17.58734692148306,233.06975516189277,177.78267356664293,False
197,150.5800433292797,55,9775,9830,9798,9816,9787,32,29,0.4727272727272728,0.5818181818181818,23,26,475.7400669143907,-328.5607598414615,-488.75608648662137,-13.016019572230675,488.75608648662137,160.19532664515987,False
198,92.52960640609565,43,9830,9873,9849,9859,9839,24,20,0.5348837209302326,0.5581395348837209,19,23,148.5718593186852,-69.96667841857573,-217.14598549150492,-68.57412617281972,217.14598549150492,147.1793070729292,False
199,79.45696802678195,45,9873,9918,9891,9907,9884,27,23,0.5208333333333333,0.6,18,25,220.4885173994086,-139.15865364885724,-217.7638345489667,2.7246828504418943,217.7638345489667,78.60518090010947,False
